PLANE 20 9
####################
#        #     *   #
#^^^^^^^^^^^^^^^^^^#
#            *     #
#^^^^^^^^^#^^^^^^^^#
# *       #        #
#^^^^^^^^^^^^^^^^^^#
#h             *   #
####################

