PLANE 26 7
##########################
#*                      e#
#                        #
#                        #
#                        #                             
#P                      h#
##########################
