PLANE 26 7
##########################
#*                       #
# ###################### #
#P          h         e  #
##########################
