PLANE 21 20
#####################
#      v            #
#      v         ^  #
#  <*> v    *    ^  #
#   v  v         ^  #
#      v         ^  #
#      v         ^  #
#      v   >>>>>>^* #
#      v    *    ^  #
#      v<<<<<<   ^  #
#      v    *    ^  #
#      v   >>>>>>^* #
#      v         ^  #
#      v         ^  #
#  *   v         ^  #
#      v     h   ^  #
#      v         ^  #
#      >>>>>>>>>>^  #
#                   #
#####################